111111111111111111111111111111111111
10000000000000000000000000C0010010C1
1000000000000000000000000000001000C1
100000000000000000000PM000C0000E00C1
10000000000000000000000000C0000010C1
111111111111111111111111111111111111