1111111111111111111111111111111111111
1MMMMMMMMMMMMMMMMMMMMMMMM1MMMMMM1MMM1
1MMMMMMMMMCMMMMMMCMMMM1MM1MM1MMM1MMM1
1MMMMME00000P00000MMMM1MM1MM1MMM1MMM1
1MMMMMMMMMMMM0MMMMMMMM1MM1MM1MMM1MMM1
1MMMMMMMMMMMM0CMMMMMMM1MMMMM1MMMMMM01
1111111111111111111111111111111111111