1111111
1P00EC1
10M0001
1111111
