111111111111111111111111111111111111
100000000000000000000M0000C0010010C1
1000000000000000000MMMM00000001000C1
1000000000000000000MMP0000C0000E00C1
10000000000000000000MMM000C0000010C1
111111111111111111111111111111111111