1111111111111111111111111111111111111
1000000000000000000000000100000010001
1000000000C000000C0000010010010001001
1000000000000000000000100100100010001
1E000000000000C00000001000001000000P1
1111111111111111111111111111111111111