1111111111111111111111111111111111111
1000000000000000000000000100000010001
1000000000C000000C0000100100100010001
100000E00000P000000000100100100010001
1000000000000000000000100100100010001
10000000000000C00000001000001000000C1
1111111111111111111111111111111111111