1111111111111111111111111111111111111
10E00000000000000000CP0000C0000010001
1111111111111111111111111111111111111