1111111111111111111111111111111111111
1000P000000000000000000001000000100E1
10000000000000000C00000100100100010001
1000000000000000000000100100100010001
1000000000000000000000100000100000001
1111111111111111111111111111111111111