1111111111
1P0000C011
1000000101
100C001001
1000010C01
1C00100001
100100C001
1010000001
1100C000E1
1111111111