1111111111111111111111111111111111111111
1CCCCCCCCCCCCCCCCCCCCCCCC1CCCCCC1CCCCCC1
1CCCCCCCCCCCCCCCCCCCCCC1CC1CC1CCC1CCCCC1
1CCCCCCCCCCCCCCCCCCCCCCCC1CCCCCC1CCCCCC1
1CCCCCCCCCCCCCCCCCCCCCC1CC1CC1CCC1CCCCC1
1CCCCCCCCCCCCCCCCCCCCCCCC1CCCCCC1CCCCCC1
1CCCCCCCCCCCCCCCCCCCCCC1CC1CC1CCC1CCCCC1
1CCCCCCCCCCCCCCCCCCCCCCCC1CCCCCC1CCCCCC1
1CCCCCCCCCCCCCCCCCCCCCC1CC1CC1CCC1CCCCC1
1CCCCCCCCCCCCCCCCCCCCCCCC1CCCCCC1CCCCCC1
1CCCCCCCCCCCCCCCCCCCCCC1CC1CC1CCC1CCCCC1
1CCCCCCCCCCCCCCCCCCCCC1CC1CC1CCC1CCCCCC1
1CCCCCCCCCCCCCCCCCCCCC1CCCCC1CCCCCCCCCC1
1CCCCCCCCCCCCCCCCCCCCC1CCCCC1CCCCCCCCCC1
1CCCCCCCCCCCCCCCCCCCCC1CCCCC1CCCCCCCCCC1
1CCCCCCCCCCCCCCCCCCCCC1CCCCC1CCCCCCCCCC1
1CCCCCCCCCCCCCCCCCCCCCCCC1CCCCCC1CCCCCC1
1CCCCCCCCCCCCCCCCCCCCCC1CC1CC1CCC1CCCCC1
1CCCCCCCCCCCCCCCCCCCCC1CC1CC1CCC1CCCCCC1
1CCCCCCCCCCCCCCCCCCCCC1CC1CC1CCC1CCCCCC1
1CCCCCCCCCCCCCCCCCCCCC1CC1CC1CCC1CCCCCC1
1CCCCCCCCCCCCCCCCCCCCC1CC1CC1CCC1CCCCCC1
1ECCCCCCCCCCCCCCCCCCCC1CCCCC1CCCCCCPCCC1
1111111111111111111111111111111111111111