11111111111111111111111111111111111
1MMMMMMMMMMMMEM000000P0000C00000001
11111111111111111111111111111111111