1111111111111111111111111111111111111
1000000000000000000000000100000010001
1000000000C000000C0M00100100100010001
100000E00000P0000000001001001M0M10001
10000000000000000M0000100100100010001
10000000000000C00000001000001000000C1
1111111111111111111111111111111111111