11111111111
10010000P10
1EC00000011
11111111111