111111111111111111111111111111111111111
1000P000000000000000000001001000100E001
10000000000000000C000000000010001000001
100000000000000000000010010010001000001
100000000000000000000010000010000000001
100000000000000000000010010010001000001
111111111111111111111111111111111111111