111111
1P0001
100001
100001
100001
100001
100001
111001
100001
10C001
100001
100111
100001
10C001
100001
100001
100001
10E001
100001
100001
1000C1
111111